#############################################################################
#                                                            #              #
#        # #                                                 #              #
#                                                            #              #
#      ########################    ###########################              #
#    #                         ##                                      #### #
#   #                            #                                     #    #
##          #   #                                                           #
# #         #   #           ################  # ##  ###   ######  # #       #
#   #                       #              #  # #                 #         #
#    #                 #######                          #         #         #
#    ##########                            #  # ###################     #   #
#                ###########################  # #     !                 # # #
#               #            #                  #     ##  #    ##  ######   #
#           #####              # # # #  #  #  #       #### # #              #
# @   #                                           #                         #
#############################################################################